#     #   # ##  ###.#...##  #  # #...###
  ###  #  # #  #....#..##### #   #.#...#
  ## ## ##    #...#...# ### # # ##.#####
  ## #   #  ## #.# ##.# # ### ##...## ##
       #  ######..####.#  ##.##A...##  #
# ####### ## # ##...#..# #...#**#.# ####
#####  #  ##  # ##...#..##.##.*#### ####
 ##     ##  ## #...###...******#...#  # 
# ####  ## ##  ##..## #..*#..#...##  #  
##      # ## # #...###..**##.....## # ##
#    #  #########.###.***# #.##..# # ## 
  # # ####### # #.....*#.##..#..##    ##
    ####      .#....##*###...##.##  ## #
 ###..#.## # #..#...##*# #.#.##.#   ## #
# .#....###.##.##.#.***# #.#.#..##  ####
##.#.***#......# ##.*######...#...#### #
##..**#*..##.######.*#   ####.#.#..# #  
##.**##*#.##..# #****.# #### # ######   
 ##*##.*#.#..#.##*###.## ####### ## #   
#  *###**......##**#### ## ##  ##     # 
#  B ##.*...#..###**#.##.#########  # ##
## # ##.*#.##.#####*****...#  ###### #  
 ####  #**######.######*#.# #  ###      
 #  ## ##****#*******##*## ###    ######
     ###..#.*#*#.###*#.*## #    # ## ## 
 ###   #..##***#....*#**####  #  ##    #
##    ##...##..#.#..***##  ##  # ##  ###
# #     ##.#### ##...#.#  ## ### #   #  
###  ## # # ## # #..# # ##   # ## #     
 #### ##### ## ##...# # ##    # ## ##  #
  ## ### #  ##   ###    #   #  # ##  ###
 ## #####  ### #  #     # # ### ##  ####
# ###   ##   # # ##   #####     #   # # 
    ## #      # ##### ### #  ##   #  ###
#    ##   ## ### # #    # # #  #   #### 
   ### # # ### ##         ##  # ##      
#  # # ####    ##   ##### ### ##  ## #  
 ########  ##       ######  ## #  ### # 
# #   ##  # # ##### #    ## ###      # #
## # ##### # # ## ## ######  ###    ## #
