#   # #..#### # ##   ######## 
#  ## ##.# ## ##  #  #    #  #
 #    #...# ####  # #    # # #
 # ###.#.###.#   ## # ## #  ##
## ##.********## # ###    #   
# ###**###.#.**.####     #   #
# # #*#..#...#*.#     # #  #  
 #.##*#...#.##A..###  ###  ## 
##.#.*#.#..###..# # # ## ## # 
.....****#....##   #### ### # 
#.#....#*##.##  # ## ##  ## ##
######.#**....#### # # # # ###
.......##******....##   #  # #
..##..#  ###.#**..#### ## ##  
## #.#    # # #*#  ##  # #  # 
#   ## ##### ##*B   ##### # ##
    # ##  # # #.##   # #    # 
##     #####    ##   # #### ##
 ### ## #      # # #  ### ##  
 ##  ### ###  #      # # # # #
