  ## #  # 
###  #A ##
#    #####
 #  # # # 
  ##  ##B#
# ## #   #
#   ### # 
 #     ###
### ## #  
##  #  ###
