##......# 
  ###..###
 #.****A##
#.**##....
..*# #...#
#.*## #.# 
 #*.## ###
#.*.#B    
##****####
##..#### #
