*B   ###  
*### ## ##
**.# # A*#
#*.#  ##*.
.*### #**#
.*******# 
..# #  #  
.### #  ##
.##### ## 
##     # #
