 #### #.#### # #   #  #  #### 
#  ####.######    ##    ##  # 
   ##B**.#   #### # # #  #####
    #..*#  ###   #   ##### # #
## #.##*## ### ##  ####     # 
####..#*# ##   # ### ## ## # #
#...#***.## #### #  ##    ####
###.**#..###   ##  # # ##  ###
##.#*.#.#########  # # #  #  #
 #***.#.#   # #  ## #  # #### 
#.*...###  ### ## ## ##     # 
.#*##.#.#  #  #..#   #.# #  ##
***.#.#..# ###....###...##### 
*#.#..#.###.###....###.##.## #
**###...#...#*******#..#..###.
.**.##...##.#*##.##***##...#..
..*#.#.##.#***.#.#.##**..#....
#.***##...#*#.#..#..##*#...#..
 ###********.##....# #*...#...
  # #####..#####..####A..#....
