 ###A#   #
 #.#*###  
##..*...##
###**#..##
###*###.##
 #**.....#
#.*##..#. 
#.*. # ##
 #*#   #  
 #B# ### #
