##  #   #  ####### #  #  #  # ## #  ##  
 #  #####  ###  # #### # #  #    ### ###
B####    #   ##  ## ##### ###  ##    ## 
# ### ###  #  # ##   # #   ### # #  #   
     # ##  # ### #  # # # ###    #    ##
   # ### #### ###        #### ##### # # 
     ## # #  ### ##  # ##  # #   ###### 
#    # # # #  # #.########  #######  ###
## ## ###### ####.A####  ##  # ###  #   
  ### ###   #  ##..### #  ###  #    # ##
#  ## ####  #  ##.....### #  ###  ## ###
# # #    # # ######..##  # # #      #   
  ### # ##    ##  ##..###     ## #  # # 
  ###   #####   #  #####  #     #   # ##
#### #  ##  ## #  #  # ###  #####  #  ##
 #  ## ### #####  ## #### # ## ## ###  #
 #  #  ## # #  ###   #  # ##### ####  ##
 ####     ##     #   ##  #  ## # ##  # #
### #    ########  # #    #      ## #  #
#  ##  ### #   ## #   ####### # # #  #  
#  #  ## ### #   #### ###    # ## #    #
  #### # # ##     # ##  ## # ##### ##   
   #####   ###  ### # #   ###  #  #   ##
###  # ##   #   #   # ## # ##  ##  ##   
# #### # # ## # # # # ## #   #  ##  ### 
## #### # #   #     # #    ##  #  ##  ##
##    # #### ### # ## # # # # #  ###  # 
 ### ##  ##  ##  #  #   # #  ##  ## # ##
##  # ### #####  ## ### #  #### ## #### 
   ## #  #   ## #  # #  #    ## ####  # 
 # #  # ##   # ## ## #### # #   ###   # 
 ## #   #  ## # #   #### ##### #  #    #
#  ##### # # ##     #    # ## # #  # ###
 ### ##  ## # # #     ####         ###  
###   #  #  ### ####   ## ## #   #  # # 
   # #    #  ##    ##   ### #### # #   #
# ## ###    ##  #   ## #####  ##  #  ###
 ## # ##     ###   ## ## #### # ###     
# #     # #   ##### ###    #   # ##  ## 
## ## ### ## # ##    # #  #####  # # ## 
