 #####   #
#   ##   #
   #   ## 
#  ## ####
######B*##
 ## # #*.#
 ## ##.*..
# # #.#*.#
#   #..A# 
# ## ##.##
