 #####   #
#   ##   #
   #   ## 
#  ## ####
######B ##
 ## # #  #
 ## ##    
# # # #  #
#   #  A# 
# ## ## ##
