 ###A#   #
 # # ###  
##      ##
###  #  ##
### ### ##
 #       #
#  ##  #  
#    # ## 
 # #   #  
 #B# ### #