#     #   # ##  ### #   ##  #  # #   ###
  ###  #  # #  #    #  ##### #   # #   #
  ## ## ##    #   #   # ### # # ## #####
  ## #   #  ## # # ## # # ### ##   ## ##
       #  ######  #### #  ## ##A   ##  #
# ####### ## # ##   #  # #   #  # # ####
#####  #  ##  # ##   #  ## ##  #### ####
 ##     ##  ## #   ###         #   #  # 
# ####  ## ##  ##  ## #   #  #   ##  #  
##      # ## # #   ###    ##     ## # ##
#    #  ######### ###    # # ##  # # ## 
  # # ####### # #      # ##  #  ##    ##
    ####       #    ## ###   ## ##  ## #
 ###  # ## # #  #   ## # # # ## #   ## #
#  #    ### ## ## #    # # # #  ##  ####
## #    #      # ##  ######   #   #### #
##    #   ## ######  #   #### # #  # #  
##   ## # ##  # #     # #### # ######   
 ## ##  # #  # ## ### ## ####### ## #   
#   ###        ##  #### ## ##  ##     # 
#  B ##     #  ###  # ## #########  # ##
## # ##  # ## #####        #  ###### #  
 ####  #  ###### ###### # # #  ###      
 #  ## ##    #       ## ## ###    ######
     ###  #  # # ### #  ## #    # ## ## 
 ###   #  ##   #     #  ####  #  ##    #
##    ##   ##  # #     ##  ##  # ##  ###
# #     ## #### ##   # #  ## ### #   #  
###  ## # # ## # #  # # ##   # ## #     
 #### ##### ## ##   # # ##    # ## ##  #
  ## ### #  ##   ###    #   #  # ##  ###
 ## #####  ### #  #     # # ### ##  ####
# ###   ##   # # ##   #####     #   # # 
    ## #      # ##### ### #  ##   #  ###
#    ##   ## ### # #    # # #  #   #### 
   ### # # ### ##         ##  # ##      
#  # # ####    ##   ##### ### ##  ## #  
 ########  ##       ######  ## #  ### # 
# #   ##  # # ##### #    ## ###      # #
## # ##### # # ## ## ######  ###    ## #
