 B   ###  
 ### ## ##
   # # A #
#  #  ##  
  ### #  #
        # 
  # #  #  
 ### #  ##
 ##### ## 
##     # #
