 #### # #### # #   #  #  #### 
#  #### ######    ##    ##  # 
   ##B   #   #### # # #  #####
    #   #  ###   #   ##### # #
## # ## ## ### ##  ####     # 
####  # # ##   # ### ## ## # #
#   #    ## #### #  ##    ####
###   #  ###   ##  # # ##  ###
## #  # #########  # # #  #  #
 #    # #   # #  ## #  # #### 
#     ###  ### ## ## ##     # 
 # ## # #  #  #  #   # # #  ##
    # #  # ###    ###   ##### 
 # #  # ### ###    ### ## ## #
  ###   #   #       #  #  ### 
    ##   ## # ## ##   ##   #  
   # # ## #    # # ##    #    
#    ##   # # #  #  ## #   #  
 ###         ##    # #    #   
  # #####  #####  ####A  #    
