##      # 
  ###  ###
 #     A##
#   ##    
   # #   #
#  ## # # 
 #  ## ###
#   #B    
##    ####
##  #### #
