#   # #  #### # ##   ######## 
#  ## ## # ## ##  #  #    #  #
 #    #   # ####  # #    # # #
 # ### # ### #   ## # ## #  ##
## ##         ## # ###    #   
# ###  ### #    ####     #   #
# # # #  #   #  #     # #  #  
 # ## #   # ##B  ###  ###  ## 
## #  # #  ###    # # ## ## # 
         #    ##   #### ### # 
# #    # ## ##  #  # ##  ## ##
###### #      ####     # # ###
       ##        # ##   #  # #
  ##  #  ### #  # #### ## ##  
## # #    # # #  # ##  # #  # 
#   ## ##### ## A   ## ## # ##
    # ##  # # #  #     #    # 
##     #####    ##   # #### ##
 ### ## #      # # #   ## ##  
 ##  ### ###  #      # # # # #
