#   # #  #### # ##   ######## 
#  ## ## # ## ##  #  #    #  #
 #    #   # ####  # #    # # #
 # ### # ### #   ## # ## #  ##
## ##         ## # ###    #   
# ###  ### #    ####     #   #
# # # #  #   #  #     # #  #  
 # ## #   # ##A  ###  ###  ## 
## #  # #  ###  # # # ## ## # 
         #    ##   #### ### # 
# #    # ## ##  # ## ##  ## ##
###### #      #### # # # # ###
       ##          ##   #  # #
  ##  #  ### #    #### ## ##  
## # #    # # # #  ##  # #  # 
#   ## ##### ## B   ##### # ##
    # ##  # # # ##   # #    # 
##     #####    ##   # #### ##
 ### ## #      # # #  ### ##  
 ##  ### ###  #      # # # # #
