 #### ### 
###  #####
  # ##A###
   #  ## #
    ## ###
#####   # 
#  #   #  
 #  ##  # 
#####  ## 
#B   # #  
